..........
.XXX......
....XXX...
..X.......
..X.XXXXX.
..X.......
....XXXX..
......XX..
..XX......
..........
